Plateau 15 17:
    01234567890123456
000 .................
001 .................
002 .................
003 .................
004 .................
005 .................
006 .................
007 .................
008 ..OOOOOOO........
009 .................
010 ..............X..
011 ..........xxXXX..
012 ..............X..
013 .................
014 .................
Piece 2 3:
.*.
***
y_offset: 0
x_offset: 0
npiece_y: 2
npiece_x: 3
extra: 1