$$$ exec p1 : [../malasalm.filler]
Plateau 15 17:
    01234567890123456
000 .................
001 .................
002 .................
003 .................
004 .................
005 .................
006 .................
007 .................
008 ..O..............
009 .................
010 .................
011 .................
012 ..............X..
013 .................
014 .................
Piece 2 1:
*
*
<got (O): [8, 2]
Plateau 15 17:
    01234567890123456
000 .................
001 .................
002 .................
003 .................
004 .................
005 .................
006 .................
007 .................
008 ..o..............
009 ..o..............
010 .................
011 .................
012 ..............X..
013 .................
014 .................
Piece 2 1:
*
*
<got (X): [11, 14]
Plateau 15 17:
    01234567890123456
000 .................
001 .................
002 .................
003 .................
004 .................
005 .................
006 .................
007 .................
008 ..O..............
009 ..O..............
010 .................
011 ..............x..
012 ..............x..
013 .................
014 .................
Piece 1 2:
**
<got (O): [9, 2]
Plateau 15 17:
    01234567890123456
000 .................
001 .................
002 .................
003 .................
004 .................
005 .................
006 .................
007 .................
008 ..O..............
009 ..oo.............
010 .................
011 ..............X..
012 ..............X..
013 .................
014 .................
Piece 2 3:
**.
...
<got (X): [12, 13]
Plateau 15 17:
    01234567890123456
000 .................
001 .................
002 .................
003 .................
004 .................
005 .................
006 .................
007 .................
008 ..O..............
009 ..OO.............
010 .................
011 ..............X..
012 .............xx..
013 .................
014 .................
Piece 2 2:
**
.*
<got (O): [9, 3]
Plateau 15 17:
    01234567890123456
000 .................
001 .................
002 .................
003 .................
004 .................
005 .................
006 .................
007 .................
008 ..O..............
009 ..Ooo............
010 ....o............
011 ..............X..
012 .............XX..
013 .................
014 .................
Piece 2 1:
*
*
<got (X): [11, 13]
Plateau 15 17:
    01234567890123456
000 .................
001 .................
002 .................
003 .................
004 .................
005 .................
006 .................
007 .................
008 ..O..............
009 ..OOO............
010 ....O............
011 .............xX..
012 .............xX..
013 .................
014 .................
Piece 1 3:
***
<got (O): [10, 4]
Plateau 15 17:
    01234567890123456
000 .................
001 .................
002 .................
003 .................
004 .................
005 .................
006 .................
007 .................
008 ..O..............
009 ..OOO............
010 ....ooo..........
011 .............XX..
012 .............XX..
013 .................
014 .................
Piece 1 3:
***
<got (X): [11, 11]
Plateau 15 17:
    01234567890123456
000 .................
001 .................
002 .................
003 .................
004 .................
005 .................
006 .................
007 .................
008 ..O..............
009 ..OOO............
010 ....OOO..........
011 ...........xxxX..
012 .............XX..
013 .................
014 .................
Piece 1 2:
**
<got (O): [10, 6]
Plateau 15 17:
    01234567890123456
000 .................
001 .................
002 .................
003 .................
004 .................
005 .................
006 .................
007 .................
008 ..O..............
009 ..OOO............
010 ....OOoo.........
011 ...........XXXX..
012 .............XX..
013 .................
014 .................
Piece 2 2:
*.
**
<got (X): [10, 10]
Plateau 15 17:
    01234567890123456
000 .................
001 .................
002 .................
003 .................
004 .................
005 .................
006 .................
007 .................
008 ..O..............
009 ..OOO............
010 ....OOOO..x......
011 ..........xxXXX..
012 .............XX..
013 .................
014 .................
Piece 2 2:
**
..
<got (O): [10, 7]
Plateau 15 17:
    01234567890123456
000 .................
001 .................
002 .................
003 .................
004 .................
005 .................
006 .................
007 .................
008 ..O..............
009 ..OOO............
010 ....OOOoo.X......
011 ..........XXXXX..
012 .............XX..
013 .................
014 .................
Piece 1 2:
**
<got (X): [10, 10]
Plateau 15 17:
    01234567890123456
000 .................
001 .................
002 .................
003 .................
004 .................
005 .................
006 .................
007 .................
008 ..O..............
009 ..OOO............
010 ....OOOOO.xx.....
011 ..........XXXXX..
012 .............XX..
013 .................
014 .................
Piece 2 3:
.**
...