Plateau 15 17:
    01234567890123456
000 .................
001 .................
002 .................
003 .................
004 .................
005 .................
006 .................
007 .........x.......
008 .OO....OOx.......
009 .OOOOO.OOXXXX....
010 .OOOOOOOOOXXX....
011 ..........XXXX...
012 ...........XXXX..
013 .................
014 .................
Piece 2 3:
***
...