$$$ exec p1 : [../malasalm.filler]
Plateau 15 17:
    01234567890123456
000 .................
001 .................
002 .................
003 .................
004 .................
005 .................
006 .................
007 .................
008 ..O..............
009 .................
010 .................
011 .................
012 ..............X..
013 .................
014 .................
Piece 2 3:
**.
***
<got (O): [8, 2]
Plateau 15 17:
    01234567890123456
000 .................
001 .................
002 .................
003 .................
004 .................
005 .................
006 .................
007 .................
008 ..oo.............
009 ..ooo............
010 .................
011 .................
012 ..............X..
013 .................
014 .................
Piece 2 3:
..*
.**
<got (X): [11, 12]
Plateau 15 17:
    01234567890123456
000 .................
001 .................
002 .................
003 .................
004 .................
005 .................
006 .................
007 .................
008 ..OO.............
009 ..OOO............
010 .................
011 ..............x..
012 .............xx..
013 .................
014 .................
Piece 2 2:
**
.*
<got (O): [9, 4]
Plateau 15 17:
    01234567890123456
000 .................
001 .................
002 .................
003 .................
004 .................
005 .................
006 .................
007 .................
008 ..oo.............
009 ..oooo...........
010 .....o...........
011 .................
012 ..............X..
013 .................
014 .................